############
#   X      #
# #   #    #
#  #  # #  #
#  #       #
#          #
#          #
# ##    # ##
#          #
#          #
#T         #
############


############
#   X      #
#        # #
##     ##  #
#     #    #
##         #
#  #       #
#          #
#  #       #
#          #
#   #  T   #
############

############
#X #       #
#        # #
# #        #
#          #
#  #       #
#          #
#          #
#        # #
###        #
#      #  T#
############

############
#X         #
#          #
#          #
#       #  #
#   #   #  #
#       #  #
#    #     #
#       #  #
# # ##     #
## T       #
############

############
#X    #    #
#  #       #
#   #      #
##    #    #
# #        #
#          #
#        ###
# #        #
#         ##
#T         #
############

############
##      X  #
#          #
#    #     #
##         #
#          #
#     #   ##
#   ##   # #
#          #
#    #    ##
#    T     #
############

############
# X      # #
#    #     #
#    #     #
#   #      #
#        ###
#         ##
#       #  #
##         #
#          #
#       T  #
############

############
#     #X   #
#       #  #
#  ## #    #
#  #       #
#          #
#        # #
#          #
#          #
# #    #   #
##T        #
############

############
##        X#
#          #
#      #   #
#       #  #
## #       #
#  #       #
#      #   #
#          #
# #        #
#  T ##    #
############

############
# #   #  #X#
# #        #
#          #
#          #
#      #   #
# #    #   #
#          #
#      #   #
#          #
#T      #  #
############

############
#X#        #
#          #
#          #
#         ##
#   ## #   #
#          #
# #        #
#   #      #
#          #
# #    #T  #
############

############
#      X   #
#  # #     #
# ##       #
#          #
#     #  # #
#          #
#    #     #
#          #
##         #
# T# #     #
############

############
#  X # #   #
#          #
#        # #
##        ##
#          #
#          #
#   #      #
#      #   #
# #        #
#  # #  T  #
############

############
# X     #  #
#          #
#        # #
#          #
#          #
#      # # #
#          #
##   # #   #
#        # #
#     T ## #
############

############
# X#       #
#          #
#  #    #  #
#          #
#     #   ##
#          #
# #        #
#         ##
#       #  #
#    T     #
############

############
#X   #   # #
#          #
##   #  #  #
#          #
#          #
#        ###
#     #    #
#          #
#          #
#T   #     #
############

############
#X         #
# # # #    #
#   #      #
#    ###   #
#        # #
#          #
#          #
#      #   #
#          #
#       T ##
############

############
#        X #
#          #
##         #
# #    #   #
#          #
#          #
#          #
#      #   #
# ##     # #
#   #  #T  #
############

############
#X   # #  ##
#   # ## # #
#     #    #
#          #
#          #
#     #    #
#          #
#          #
#          #
#      #T  #
############

############
#     X    #
#    #     #
#         ##
#   #      #
#      #   #
#     #    #
#        # #
#      #   #
#        # #
#   #   T  #
############
